#######################
#A                    #
# ####### ######### ###
#       #     #       #
# ####### # ####### ###
# #       #       #   #
### ########### #######
# #             #     #
# # ############# #####
# # #           # #   #
# # # ######### # # ###
#   # #       # # #   #
# # # # ##### # # ## ##
# #   # #     # #     #
# ### ### ##### ### ###
#   #   #       #     #
### ##### ##### ##### #
#   #   #   #   #     #
# ### # ### # ### ## ##
#     #   # # #   #   #
# ###### ## # ## ## ###
# #       # # #   #   #
# # ##### # # ### #####
# # #   # #     #     #
# # # # # # ##### ### #
#   # #     #   #  #  #
######## #### ####### #
#B                    #
#######################