#########################
#A          # #         #
#  #### # # # # ##### ###
#     # # # # # #   #   #
##### ### # # # # # ### #
#   #     # #   # # #   #
# ######### # ### # # # #
#   #       # #   # # # #
# # # ####### # ### # # #
# # # # #     # #   # # #
# # # # # ##### # ### # #
# # # #   #   # #     # #
# # # ##### # # ####### #
# # #       # #   #     #
# # ######### ### ### ###
# # #       #   #   # # #
# # # ##### ### # # # # #
# #   #   #   # # # # # #
# ##### ##### # ### # # #
#     # #     # #   #   #
##### # # ##### # ##### #
#   # # # #   # # #   # #
# # # # # # # # # # # # #
# #     #   #     # #  B#
#########################
